SYMBOL	Type
HLA-A	MHC I
HLA-B	MHC I
HLA-C	MHC I
HLA-E	MHC I
HLA-F	MHC I
HLA-G	MHC I
HLA-H	MHC I
HLA-DMA	MHC II
HLA-DMB	MHC II
HLA-DOA	MHC II
HLA-DOB	MHC II
HLA-DPA1	MHC II
HLA-DPB1	MHC II
HLA-DQA1	MHC II
HLA-DQA2	MHC II
HLA-DQB1	MHC II
HLA-DRA	MHC II
HLA-DRB1	MHC II
HLA-DRB3	MHC II
HLA-DRB4	MHC II
HLA-DRB5	MHC II
